##############################
# x   #######  ###    ##  o ##
#      ###             ##    #
#   #         ## ##    ##    #
#             ####         ###
#   #####        ##    ##    #
#   #  ##                    #
#   ####   ####    ##        #
#          ##  ####  #  #    #
#   ##   ###  #####          #
#                       #    #
##############################
